#########################################
#.....#.......#...#...#...........#.....#
#.#.###.#####.#.#.#.#.#.#####.###.#.#.#.#
#.#.....#...#.#.#...#.......#.#...#.#.#.#
#.#######.###.#.#############.#.#####.#.#
#...#.....#...#.......#.......#.......#.#
###.###.###.#########.#.###############.#
#O#.....#...#...#.....#...#.#.........#.#
#.#####.#.###.#.#.#######.#.#.#####.###.#
#.#.....#...#.#.........#.#.#.#...#.#...#
#.#.#####.#.#.#####.#####.#.#.#.#.#.#.###
#...#...#.#...#...#.#.....#.#.#.#.#.#.#.#
#.###.#.#######.#.###.#####.#.#.#.#.#.#.#
#.#...#.........#...#.#.......#.#.#.#.#.#
###.###############.#.#.#######.#.#.#.#.#
#...#.................#.#.#.....#...#.#.#
#.###.#################.#.#.#########.#.#
#...#.#.............#.....#.#.........#.#
###.###.###########.#######.#.#########.#
#...#...#.......#.#...#...#.#.....#.....#
#.###.###.#####.#.###.#.#.#.#####.#.###.#
#.#...#...#...#...#.#D#.#.#.#.....#.#.#.#
#.#.#####.#.#.###.#.###.#.#.#.#####.#.#.#
#.#.#.....#.#.#...#...#.#.#.#.#.....#...#
#.#.###.###.#.#.###.#.#.#.#.#.#####.#.###
#.#.#...#.#.#...#...#...#.#.#.....#.#...#
#.#.#.###.#.#####.#######.#.#####.#.###.#
#...#.#...#.#.....#.......#.....#...#...#
#####.#.###.#.#####.###########.#####.###
#.....#...#.#.#.....................#...#
#.###.#.#.#.#.#######.#####.#######.###.#
#.#...#.#...#.......#.#...#.#...#.....#.#
#.#.###.#########.#.#.#.#.###.#.#.#####.#
#.#.#...........#.#.#.#.#.....#.#.#.....#
###.###########.###.###.#######.###.#####
#...#.....#...#.....#...#.#.....#...#...#
#.###.###.#.#.#####.#.###.#.###.#.###.#.#
#.....#...#.#.#...#.#.....#.#...#...#.#.#
#.#####.###.#.#.#.#######.#.#######.###.#
#.....#.....#...#.........#.............#
#########################################