........................................#########
........................................#.......#
........................................#.......#
........................................#.......#
......................#########.........#.......#
......................#.......#.........#.......#
......................#.......#.........#.......#
......................#.......#.........#.......#
......................#.......#.........#.......#
......................#.......#.........#.......#
..........###########.#.......#.......###########
..........#.........#.#.......#.......#.#........
..........#.........#.#.......###########........
..........#.........#.#...............#..........
..........#...#########...............#..........
..........#...#.....#.................#..........
..........#...#.....#.................#..........
..........#...#.....#.................#..........
..........#...#.....#.................#..........
..........#...#.....#.................#..........
........###########.#############.....#..........
........#.#...#...#.............#.....#..........
###########...##########^...###########..........
#.......#.........#.........#...#................
#.......#.........#.........#...#................
#.......#.........#.........#...#................
#.......#.........#.........#...#................
#.......#.........#.........#...#................
#.......#.........#.........#...#................
#.......#.........#.........#...#................
#.......#.........#############.###########......
#.......#...................#.#...........#......
#########...................#############.#......
..............................#.........#.#......
..............................#.........#.#......
..............................#.........#.#......
..............................#.........#.#......
..............................#.........#.#......
..............................#...#########......
..............................#.........#........
..............................###########........